#######
#SVSBS#
#@XBXO#
#SBS^S#
#######