###############
#X>XXXXXBXX^SO#
#XSXXVXSXXXXXB#
#XXXBXXXXXXXXX#
#@XXSXXSXXBXXB#
###############
