#######
#SVSVS#
#@BBBO#
#S^S^S#
#######