####################
#SSS#XEXXXXXXXXXXVX#
#SSS#XXXSXXXXXXXXXX#
##>##XXXXXXXXXXXX>X#
#XXXXXSXSXXXXXXXXXX#
#XXXXXXXXXX<XXXXXXX#
#X^XX^XXXXXXXXXXXX@#
####################
